#.#...##..
...##.#...
##..#.#..#
.##...&...
..##@###.#
.###.#..#.
###..##.##
.#..##....
.##..####.
..#...#..#